################
#              #
#              #
#              #
#              #
#              #
# @       X    #
############## #
#s#C           #
################
#              #
#              #
#              #
#              #
#              #
################
