################
#              #
#              #
#              #
#      o       #
#              #
#              #
#      X       #
#              #
#      @       #
#G L V    V L G#
######    ######
#s     o      d#
######    ######
#    # CC #    #
################
