################
#              #
# # ###        #
# #C#  #C      #
# ###   #      #
#              #
# @       X    #
######## ##### #
#s#C           #
################
#              #
#              #
#              #
#              #
#              #
################
